g g g g g g g g g g g g g g s s w w w
g g g g g g g g g g g g g g s s w w w
g g g g g g g g g g g g g g s s w w w
g g g g g g g g g g g g g g s s w w w
g g g g g g g g g g g g g g s s w w w
g g g g g g g g g g g g g g s s w w w
g g g g g g g g g g g g g g s s w w w
g g g g g g g g g g g g g s s s w w w
g g g g g g g g g g g s s s s s w w w
s s s s s s s s s s s s s s s s w w w
s s s s s s s s s s s s s s s s w w w
w w w w w w w w w w w w w w w w w w w
w w w w w w w w w w w w w w w w w w w